1111111111111111
1C00000000000000E1
111110000000001
1P000000000001
1C0000000C00001
111111111111
