111111111111111111111111111111111111
1C0000000X000000E0000000000000000001
11110000XXXXXX0000000011000000100001
100000111111110000000001000000100001
10000000000X010000000001000000100001
1000101P1000010000000001000000100001
1000101110C0010000000001000000100001
1000000C1000X00C00000001000000100001
100000000000000000000001000000100001
100000000000000000000001000000100001
1C0000000X00000000000001000000100001
111100000000000000000001000000100001
100000111111110000000001000000100001
10000000000X010000000001000000100001
100010101000010000000001000000100001
1000101110C0010000000001000000100001
1000000C1000X00C00000001000000100001
111111111111111111111111111111111111
