1111111111111111111111111111111
1C0000000X000000E00000000000001
10000000X000000000000011X000001
1000001111111100000000010000001
11111000000X0100000000010000001
1000101P1000010000000001000C001
1000101110C00100000000010000001
1000000C1000X00C00000001000C001
1000000000000000000000010000001
100000000000000000000001000C001
1C0000000X000000000000010000001
1111000000000000000000010000X01
1000001111111111000000010000001
10000000000X0000000000000000001
10001C1001001001000X00000000001
10001110010111010000000C0000001
1000001C01001001000000000000001
1111111111111111111111111111111
