11111111111111
1P0000000000E1
100C0000C00001
1000000000C001
10000C00000001
1C0000000000C1
11111111111111
