111111111111111111
1C0000000X000000E1
111100000000000001
100000111111110001
10000000000X010001
1000101P1000010001
1000101110C0010001
1000000C1000X00C01
111111111111111111
