111111111C1111111
10000000000P00001
1000C000000000001
10000000000000001
100000000E0000001
10X00000000000001
11111111111111111
