1111111111111111111111111111111111111111111111111111111111111111111111
1C0000000X000000E000000000000000X000000000X0000000000C0000X000001C0001
11110000X000000000000011X00000100000000000X000000000000000X00000100001
100000111111110000000001000000100000000000000X010000000001000000100001
10000000000X010000000001000000100000000000000X010000000001000000100001
1000101P10000100000000010000000000000C0000000X010000000001000000100001
1000101110C0010000000001000000000000000000000X010000000001000000100001
1000000C1000X00C00000001000000000000000000000X010000000001000000100001
100000000000000000000001000000000000000000000X0100000000000000001000C1
100000000000000000000001000000100000000000000X010000000000000000100001
1C0000000X000000000000010000001000000000000000000000000000000000100001
1111000000000000000000010000X01000000000000000000000000001000000100001
1000001111111100000000010000001000000000000000000000000001000000100001
10000000000X0100000000000000001000000000000000000000000001000000100001
1000101010000100000X00000000001000000000000000000000000001000000100001
1000101110C001000000000000000010000000000000C0000000000001000000000001
1000000C1000X00C000000000000001000000000000000000000000001000000000001
1111111111111111111111111111111111111111111111111111111111111111111111
